 ################### 
 #........P........# 
 #.##.#.#####.#.##.# 
 #....#...#...#....# 
 #.######.#.######.# 
 #^...#.......#...^# 
 ####.###.#.###.#### 
    # #   O   # #    
##### # ##### # #####
 ....   # G #   .... 
##### # ##### # #####
    # #       # #    
 ####.#.#####.#.#### 
 #^.......#.......^# 
 #.##.###.#.###.##.# 
 #..#...........#..# 
 ##.#.#.#####.#.#.## 
 #....#...#...#....# 
 #.######.#.######.# 
 #.................# 
 ################### 